8,8,0
4,4,2,2,4,4,1,1
4,4,2,2,4,4,1,1
2,2,4,4,2,1,4,4
1,1,4,4,1,2,4,4
6,6,2,2,4,4,2,1
6,6,2,2,4,4,1,0
1,1,6,6,1,1,4,4
1,1,6,6,0,2,4,4