8,8,0
2,0,1,0,1,1,1,1
2,6,6,1,2,4,4,1
2,6,6,1,2,4,4,1
0,1,2,2,1,1,2,1
1,2,1,1,2,2,2,0
1,4,4,1,2,5,5,2
1,4,4,1,2,5,5,2
1,1,1,1,2,2,2,2