7,6,1
6,6,1,1,1,1,2
6,6,1,6,6,1,2
1,2,2,6,6,2,0
2,5,5,1,2,2,2
2,5,5,2,4,4,2
1,1,1,2,4,4,2