5,5,0
1,1,0,3,3
1,2,4,4,3
1,2,4,4,2
1,2,2,2,2
1,2,0,2,2