5,5,0
1,1,0,2,2
1,2,4,4,2
1,2,4,4,2
1,1,2,2,2
1,2,0,2,2